4SIGHT HOLDINGS LIMITED | 4SI.JO
A E C I LIMITED | 
ABSA GROUP LIMITED | ABG.JO
ACCELERATE PROPERTY FUND LIMITED | APF.JO
ACSION LIMITED | ACS.JO
ADCOCK INGRAM HOLDINGS LIMITED | AIP.JO
ADCORP HOLDINGS LIMITED | ADR.JO
ADVTECH LIMITED | ADH.JO
AFINE INVESTMENTS LIMITED | ANI.JO
AFRICAN & OVERSEAS ENTERPRISES LIMITED | 
AFRICAN DAWN CAPITAL LIMITED | ADW.JO
AFRICAN MEDIA ENTERTAINMENT LIMITED | AME.JO
AFRICAN RAINBOW MINERALS LIMITED | ARI.JO
AFRIMAT LIMITED | AFT.JO
AFROCENTRIC INVESTMENT CORPORATION LIMITED | ACT.JO
AGRA LIMITED | 
AH-VEST LIMITED | AHL.JO
ALEXANDER FORBES GROUP HOLDINGS LIMITED | AFH.JO
ALPHA NAMIBIA INDUSTRIES RENEWABLE POWER LIMITED | 
ALPHAMIN RESOURCES CORPORATION | 
ALTRON LIMITED | AEL.JO
ALTVEST CAPITAL LIMITED | 
ANDRADA MINING LIMITED | 
ANGLO AMERICAN PLC | 
ANGLO AMERICAN PLC | 
ANGLOGOLD ASHANTI PLC | ANG.JO
ANHEUSER-BUSCH INBEV SA/NV | 
ARCELORMITTAL SOUTH AFRICA LIMITED | ACL.JO
aReit PROP LIMITED | 
ARGENT INDUSTRIAL LIMITED | ART.JO
ASCENDIS HEALTH LIMITED | ASC.JO
ASPEN PHARMACARE HOLDINGS LIMITED | APN.JO
ASSURA PLC | AHR.JO
ASTORIA INVESTMENTS LIMITED | 
ASTRAL FOODS LIMITED | ARL.JO
ATTACQ LIMITED | ATT.JO
AVENG LIMITED | AEG.JO
AVI LIMITED | AVI.JO
AYO TECHNOLOGY SOLUTIONS LIMITED | AYO.JO
B2GOLD CORPORATION | 
BALWIN PROPERTIES LIMITED | BWN.JO
BANNERMAN ENERGY LIMITED | 
BARLOWORLD LIMITED | BAW.JO
BELL EQUIPMENT LIMITED | BEL.JO
BHP GROUP LIMITED | 
BID CORPORATION LIMITED | BID.JO
BLUE LABEL TELECOMS LIMITED | BLU.JO
BOWLER METCALF LIMITED | BCF.JO
BOXER RETAIL LIMITED | BOX.JO
BRAIT PLC | BAT.JO
BRIKOR LIMITED | BIK.JO
BRIMSTONE INVESTMENT CORPORATION LIMITED | BRN.JO
BRITISH AMERICAN TOBACCO PLC | 
BURSTONE GROUP LIMITED | BTN.JO
BYTES TECHNOLOGY GROUP PLC | BYI.JO
CA SALES HOLDINGS LIMITED | CAA.JO
CAFCA LIMITED | 
CALGRO M3 HOLDINGS LIMITED | CGR.JO
CAPITAL APPRECIATION LIMITED | CTA.JO
CAPITEC BANK HOLDINGS LIMITED | CPI.JO
CAPRICORN GROUP LIMITED | 
CASHBUILD LIMITED | CSB.JO
CASTLEVIEW PROPERTY FUND LIMITED | CVW.JO
CAXTON AND CTP PUBLISHERS AND PRINTERS LIMITED | CAT.JO
CELSIUS RESOURCES LIMITED | 
CHOPPIES ENTERPRISES LIMITED | CHP.JO
CILO CYBIN HOLDINGS LIMITED | 
CITY LODGE HOTELS LIMITED | CLH.JO
CLICKS GROUP LIMITED | CLS.JO
CLIENTELE LIMITED | 
COLLINS PROPERTY GROUP LIMITED | CPP.JO
COMBINED MOTOR HOLDINGS LIMITED | CMH.JO
COMPAGNIE FINANCIERE RICHEMONT SA | 
CONDUIT CAPITAL LIMITED | 
COPPER 360 LIMITED | CPR.JO
CORONATION FUND MANAGERS LIMITED | CML.JO
CROOKES BROTHERS LIMITED | CKS.JO
CURRO HOLDINGS LIMITED | COH.JO
DATATEC LIMITED | DTC.JO
DEEP YELLOW LIMITED | 
DELTA PROPERTY FUND LIMITED | DLT.JO
DENEB INVESTMENTS LIMITED | DNB.JO
DEUTSCHE KONSUM REIT-AG | 
DIPULA PROPERTIES LIMITED | DIB.JO
DIS-CHEM PHARMACIES LIMITED | DCP.JO
DISCOVERY LIMITED | DSY.JO
DRDGOLD LIMITED | DRD.JO
EASTERN PLATINUM LIMITED | EPS.JO
EFORA ENERGY LIMITED | EEL.JO
ELEVATE URANIUM LIMITED | 
ELLIES HOLDINGS LIMITED | 
eMEDIA HOLDINGS LIMITED | EMH.JO
EMIRA PROPERTY FUND LIMITED | EMI.JO
enX GROUP LIMITED | ENX.JO
EPE CAPITAL PARTNERS LIMITED | 
EQUITES PROPERTY FUND LIMITED | EQU.JO
EUROPA METALS LIMITED | EUZ.JO
EXEMPLAR REITAIL LIMITED | EXP.JO
EXXARO RESOURCES LIMITED | EXX.JO
FAIRVEST LIMITED | FTB.JO
FAMOUS BRANDS LIMITED | FBR.JO
FINBOND GROUP LIMITED | FGL.JO
FIRSTRAND LIMITED | FSR.JO
FIRSTRAND LIMITED | FSR.JO
FIRSTRAND NAMIBIA LIMITED | 
FORSYS METALS CORPORATION | 
FORTRESS REAL ESTATE INVESTMENTS LIMITED | FFB.JO
FRONTIER PROPERTY FUND LIMITED | 
FRONTIER TRANSPORT HOLDINGS LIMITED | FTH.JO
GEMFIELDS GROUP LIMITED | GML.JO
GLENCORE PLC | 
GLOBE TRADE CENTRE S.A. | 
GOLD FIELDS LIMITED | GFI.JO
GRAND PARADE INVESTMENTS LIMITED | GPL.JO
GREENCOAT RENEWABLES PLC | 
GRINDROD LIMITED | GND.JO
GROWTHPOINT PROPERTIES LIMITED | GRT.JO
HAMMERSON PLC | HMN.JO
HARMONY GOLD MINING COMPANY LIMITED | 
HERIOT REIT LIMITED | 
HOSKEN CONSOLIDATED INVESTMENTS LIMITED | HCI.JO
HUDACO INDUSTRIES LIMITED | HDC.JO
HUGE GROUP LIMITED | HUG.JO
HULAMIN LIMITED | HLM.JO
HYPROP INVESTMENTS LIMITED | HYP.JO
IMPALA PLATINUM HOLDINGS LIMITED | IMP.JO
INSIMBI INDUSTRIAL HOLDINGS LIMITED | ISB.JO
INVESTEC LIMITED | 
INVESTEC LIMITED | 
INVESTEC PLC | INP.JO
INVICTA HOLDINGS LIMITED | IVT.JO
iOCO LIMITED | IOC.JO
ISA HOLDINGS LIMITED | ISA.JO
ITALTILE LIMITED | ITE.JO
JSE LIMITED | JSE.JO
JUBILEE METALS GROUP PLC | JBL.JO
KAL GROUP LIMITED | KAL.JO
KAP LIMITED | KAP.JO
KAROOOOO LIMITED | 
KIBO ENERGY PLC | KBO.JO
KORE POTASH PLC | 
KORYX COPPER INC | 
KUMBA IRON ORE LIMITED | KIO.JO
LABAT AFRICA LIMITED | LAB.JO
LESAKA TECHNOLOGIES INC | LSK.JO
LETSHEGO HOLDINGS (NAMIBIA) LIMITED | 
LEWIS GROUP LIMITED | LEW.JO
LIBSTAR HOLDINGS LIMITED | LBR.JO
LIFE HEALTHCARE GROUP HOLDINGS LIMITED | LHC.JO
LIGHTHOUSE PROPERTIES PLC | LTE.JO
MAHUBE INFRASTRUCTURE LIMITED | MHB.JO
MANTENGU MINING LIMITED | MTU.JO
MARSHALL MONTEAGLE PLC | MMP.JO
MAS PLC | 
MASTER DRILLING GROUP LIMITED | MDI.JO
MC MINING LIMITED | MCZ.JO
MERAFE RESOURCES LIMITED | MRF.JO
METAIR INVESTMENTS LIMITED | MTA.JO
METROFILE HOLDINGS LIMITED | MFL.JO
MOBILE TELECOMMUNICATIONS LIMITED (MTC) | 
MOMENTUM GROUP LIMITED | MTM.JO
MOMENTUM GROUP LIMITED | MTM.JO
MONDI PLC | MNP.JO
MONTAUK RENEWABLES INC | MKR.JO
MOTUS HOLDINGS LIMITED | MTH.JO
MPACT LIMITED | MPT.JO
MR PRICE GROUP LIMITED | MRP.JO
MTN GROUP LIMITED | MTN.JO
MULTICHOICE GROUP LIMITED | MCG.JO
MURRAY & ROBERTS HOLDINGS LIMITED | MUR.JO
MUSTEK LIMITED | MST.JO
NAMIBIA ASSET MANAGEMENT LIMITED | 
NAMIBIA BREWERIES | 
NAMPAK LIMITED | NPK.JO
NASPERS LIMITED | NPN.JO
NEDBANK GROUP LIMITED | NED.JO
NEDBANK GROUP LIMITED | NED.JO
NEPI ROCKCASTLE N.V | NRP.JO
NETCARE LIMITED | NTC.JO
NEWPARK REIT LIMITED | 
NICTUS HOLDINGS LIMITED | 
NICTUS LIMITED | NCS.JO
NINETY ONE LIMITED | NY1.JO
NINETY ONE PLC | N91.JO
NORTHAM PLATINUM HOLDINGS LIMITED | NPH.JO
NOVUS HOLDINGS LIMITED | NVS.JO
NUMERAL LIMITED | XII.JO
NUTUN LIMITED | NTU.JO
NU-WORLD HOLDINGS LIMITED | NWL.JO
OANDO PLC | OAO.JO
OASIS CRESCENT PROPERTY FUND | OAS.JO
OCEANA GROUP LIMITED | OCE.JO
OCEANA GROUP LIMITED | OCE.JO
OCTODEC INVESTMENTS LIMITED | OCT.JO
OLD MUTUAL LIMITED | OMU.JO
OLD MUTUAL LIMITED | OMU.JO
OMNIA HOLDINGS LIMITED | OMN.JO
ORION MINERALS LIMITED | ORN.JO
ORYX PROPERTIES LIMITED | 
OUTsurance GROUP LIMITED | OUT.JO
PALADIN ENERGY LIMITED | 
PAN AFRICAN RESOURCES PLC | PAN.JO
PARATUS NAMIBIA HOLDINGS LIMITED | 
PBT GROUP LIMITED | PBG.JO
PEPKOR HOLDINGS LIMITED | PPH.JO
PICK N PAY STORES LIMITED | PIK.JO
POWERFLEET INC | PWR.JO
PPC LIMITED | PPC.JO
PREMIER GROUP LIMITED | PMR.JO
PRIMARY HEALTH PROPERTIES PLC | 
PRIMESERV GROUP LIMITED | PMV.JO
PROSUS N.V | PRX.JO
PSG FINANCIAL SERVICES LIMITED | KST.JO
PSG FINANCIAL SERVICES LIMITED | KST.JO
PSV HOLDINGS LIMITED | 
PURPLE GROUP LIMITED | PPE.JO
PUTPROP LIMITED | PPR.JO
QUANTUM FOODS HOLDINGS LIMITED | 
QUILTER PLC | QLT.JO
RAINBOW CHICKEN LIMITED | RBO.JO
RANDGOLD & EXPLORATION COMPANY LIMITED | RNG.JO
RAUBEX GROUP LIMITED | RBX.JO
RCL FOODS LIMITED | RCL.JO
RECONNAISSANCE ENERGY AFRICA LIMITED | 
REDEFINE PROPERTIES LIMITED | RDF.JO
REINET INVESTMENTS S.C.A | RNI.JO
REMGRO LIMITED | REM.JO
RENERGEN LIMITED | REN.JO
RESILIENT REIT LIMITED | RES.JO
REUNERT LIMITED | RLO.JO
REX TRUEFORM GROUP LIMITED | RTN.JO
RFG HOLDINGS LIMITED | RFG.JO
RH BOPHELO LIMITED | RHB.JO
RMB HOLDINGS LIMITED | RMH.JO
SA CORPORATE REAL ESTATE LIMITED | SAC.JO
SABLE EXPLORATION AND MINING LIMITED | SXM.JO
SABVEST CAPITAL LIMITED | SBP.JO
SAFARI INVESTMENTS (RSA) LIMITED | SAR.JO
SAIL MINING GROUP LIMITED | 
SALUNGANO GROUP LIMITED | 
SANLAM LIMITED | SLM.JO
SANTAM LIMITED | SNT.JO
SANTOVA LIMITED | SNV.JO
SAPPI LIMITED | SAP.JO
SASOL LIMITED | SOL.JO
SAVANNA BEEF PROCESSORS LIMITED | 
SBN HOLDINGS LIMITED | 
SCHRODER EUROPEAN REAL ESTATE INVESTMENT TRUST PLC | 
SEA HARVEST GROUP LIMITED | SHG.JO
SEBATA HOLDINGS LIMITED | SEB.JO
SEPHAKU HOLDINGS LIMITED | SEP.JO
SHAFTESBURY CAPITAL PLC | SHC.JO
SHOPRITE HOLDINGS LIMITED | 
SHUKA MINERALS PLC | SKA.JO
SIBANYE STILLWATER LIMITED | SSW.JO
SIRIUS REAL ESTATE LIMITED | SRE.JO
SOUTH OCEAN HOLDINGS LIMITED | SOH.JO
SOUTH32 LIMITED | S32.JO
SOUTHERN PALLADIUM LIMITED | SDL.JO
SOUTHERN SUN LIMITED | SSU.JO
SPEAR REIT LIMITED | SEA.JO
SPUR CORPORATION LIMITED | 
STADIO HOLDINGS LIMITED | SDO.JO
STANDARD BANK GROUP LIMITED | SBK.JO
STEFANUTTI STOCKS HOLDINGS LIMITED | SSK.JO
STIMULUS INVESTMENTS LIMITED | 
STOR-AGE PROPERTY REIT LIMITED | SSS.JO
SUN INTERNATIONAL LIMITED | SUI.JO
SUPER GROUP LIMITED | SPG.JO
SUPERMARKET INCOME REIT PLC | 
SYGNIA LIMITED | SYG.JO
TADVEST LIMITED | 
TELEMASTERS HOLDINGS LIMITED | TLM.JO
TELKOM SA SOC LIMITED | 
TEXTON PROPERTY FUND LIMITED | TEX.JO
THARISA PLC | THA.JO
THE BIDVEST GROUP LIMITED | BVT.JO
THE FOSCHINI GROUP LIMITED | TFG.JO
THE SPAR GROUP LIMITED | 
THUNGELA RESOURCES LIMITED | TGA.JO
TIGER BRANDS LIMITED | TBS.JO
TONGAAT HULETT LIMITED | TON.JO
TRANSPACO LIMITED | TPC.JO
TRELLIDOR HOLDINGS LIMITED | TRL.JO
TREMATON CAPITAL INVESTMENTS LIMITED | TMT.JO
TRUSTCO GROUP HOLDINGS LIMITED | 
TRUWORTHS INTERNATIONAL LIMITED | TRU.JO
TRUWORTHS INTERNATIONAL LIMITED | TRU.JO
TSOGO SUN LIMITED | TSG.JO
UNIVERSAL PARTNERS LIMITED | UPL.JO
VALTERRA PLATINUM LIMITED | VAL.JO
VISUAL INTERNATIONAL HOLDINGS LIMITED | VIS.JO
VODACOM GROUP LIMITED | VOD.JO
VUKILE PROPERTY FUND LIMITED | VKE.JO
VUKILE PROPERTY FUND LIMITED | VKE.JO
VUNANI LIMITED | VUN.JO
WE BUY CARS HOLDINGS LIMITED | 
WEAVER FINTECH LIMITED | 
WESIZWE PLATINUM LIMITED | 
WILSON BAYLY HOLMES-OVCON LIMITED | WBO.JO
WOOLWORTHS HOLDINGS LIMITED | WHL.JO
YORK TIMBER HOLDINGS LIMITED | YRK.JO
ZEDA LIMITED | ZZD.JO
ZEDER INVESTMENTS LIMITED | 
